10 10
..........
..##..##..
..##..##..
....FF....
....FF....
....WW....
....WW....
..........
..........
..........
..........
